TTTTTTPT
TRRRRRRR
TTTTTTTT
TTTTTTTT
PRTBTRPT
TRTTRTTT
TRRTRTTT
PTTRPTTT
