TTTTTTPT
PRRRTRRR
TTTTRTTT
TTTTTTTT
PRTBTRPT
TRTTRTTT
TRRTRTTT
PTTRPTTT
